########################################
# #                         #        #X#
# ###### # # ####################### # #
# ###### # # ##############       ## # #
# #      # #              # ##### ## # #
# ######## ################ ##### ## # #
#         R                     # ## # #
#################################      #
#                                 #### #
########################################
